________________
|**************|
|**************|
|******S*******|
|**************|
|**************|
----------------