________________
|FFFFFFFFFFFFFF|
|FFFFFFFFFFFFFF|
|FFFFFFSFFFFFFF|
|FFFFFFFFFFFFFF|
|FFFFFFFFFFFFFF|
----------------