FFFFFFFFFFFFFFFFFFFFFFFFFFF
|FFF|F|---F|FFFF|FFFFFF___F
|FFF|F|FFFF|FFFF|FFFFF|FFF|
|---|F|--FF|FFFF|FFFFF|FFF|
|FFF|F|FFFF|FFFF|FFFFF|FFF|
|FFF|F|___F|___F|___FF|FFF|
FFFFFFFFFFFFFFFFFFFFFFF---F
FFF_____F|---FF___FF|--|--|
FFFFF|FFF|FFFF|FFF|F|FF|FF|
FFFFF|FFF|--FF|___|F|FF|FF|
FFFFF|FFF|FFFF|FFF|F|FF|FF|
FFFFF|FFF|___F|FFF|F|FF|FF|
FFFFFFFFFFFFFSFFFFFFFFFFFFF
FFFFFFFFFFFFFFFFFFFFFFFFFFF